111111111111111111111111111111111111111111111111111111111111111111111111111111111111111111111111111111
100000000000000000000000000000000000000000000000000000000000000000000000000000000000000000000000000011
100000000000000000000000000000000000000000000000000000000000000000000000000000000000000000000000000011
100000000010000000000000000000000000000000000000000000000000000000000000000000000000000000000000000011
100000000000000000000000000000000000000000000000000000000000000000000000000000000000000000000000000011
100000000000000000000000000000000000000000000000000000000000000000000000000000000000000000000000000011
100000000000000000000000020000000000000000000000000000000000000000000000000000000000000000000000000011
100000000000000000000000000000000000000000000000000000000000000000000000000000000000000000000000000011
100000000000000000000000000000000000000000000000000000000000000000000000000000000000000000000000000011
100000000000000000040000000000000000000000000000000000000000000000000000000000000000000000000000000011
100000000000000000000000000000003000000000000000000000000000000000000000000000000000000000000000000011
110000000000000000000000000000000000000000000000000000000000000000000000000000000000000000000000000011
100000000000000000000000000000000000000000000000000000000000000000000000000000000000000000000000000011
100000000000000000000000000000000000000000000000000000000000000000000000000000000000000000000000000011
100000000000000000000000000000000000000000000000000000000000000000000000000000000000000000000000000011
100000000000000000000000000000000000000000000000000000000000000000000000000000000000000000000000000011
100000000000000000000000000000000000000000000000000000000000000000000000000000000000000000000000000011
100000000000000000000000000@@@@@@@@@@@@000000000000000000000000000000000000000000000000000000000000001
10000000000000000000000000@@@@@@@@@@@@@@00000000000000000000000000000000000000000000000000000000000001
1000000000000000000000000@@@@@@@@@@@@@@@@0000000000000000000000000000000000000000000000000000000000001
1000000000000000000000000@@@@@@@@@@@@@@@@@000000000000000000000000000000000000000000000000000000000001
1000000000000000000000000@@@@@@@@@@@@@@@@@000000000000000000000000000000000000000000000000000000000001
1000000000000000000000000@@@@@@@@@@@@@@@@@000000000000000000000000000000000000000000000000000000000001
1000000000000000000000000@@@@@@@@@@@@@@@@@000000000000000000000000000000000000000000000000000000000001
1000000000000000000000000@@@@@@@@@@@@@@@@@000000;<999999>?00000000000000000000000000000000000000000001
1000000000000000000000000@@@@@@@@@@@@@@@@@000000089999998000000000000000000000000000000000000000000001
1000000000000000000000000@@@@@@@@@@@@@@@@0000000089999:98000000000000000000000000000000000000000000001
10000000000000000000000000@@@@@@@@@@@@@@00000000089999998000000000000000000000000000000000000000000001
10000000000000000000000000@@@@@@@@@@@@@@00000000567777776000000000000000000000000000000000000000000001
1000000000000000000000000@@@@@@@@@@@@@@000000000000000000000000000000000000000000000000000000000000001
100000000000000000000000@@@@@@@@@@@@@@0000000000000000000000000000000000000000000000000000000000000001
100000000000000000000000@@@@@@@@@@@@@00000000000000000000000000000000000000000000000000000000000000001
100000000000000000000000@@@@@@@@@@@@000000000000000000000000000000000000000000000000000000000000000001
100000000000000000000000@@@@@@@@@@00000000000000000000000000000000000000000000000000000000000000000001
1000000000000000000000000@@@@@@00000000000000000000000000000000000000000000000000000000000000000000001
100000000000000000000000000000000000000000000000000000000000000000000000000000000000000000000000000001
100000000000000000000000000000000000000000000000000000000000000000000000000000000000000000000000000001
100000000000000000000000000000000000000000000000000000000000000000000000000000000000000000000000000001
100000000000000000000000000000000000000000000000000000000000000000000000000000000000000000000000000001
100000000000000000000000000000000000000000000000000000000000000000000000000000000000000000000000000001
111111111111111111111111111111111111111111111111111111111111111111111111111111111111111111111111111111